{
  "height": 28,
  "legend": {
    "!": "12bc00",
    "#": "333333",
    "$": "666666",
    "%": "76582c",
    "&": "b5bb47",
    "'": "cab989",
    "(": "cc9900",
    ")": "ffb8d9",
    "*": "ffc600",
    "+": "ffe242",
    ",": "fffabc"
  },
  "name": "dragon-ball-imperfect-cell-stage-1-ki-charge",
  "pixels": [
    "             *      *                      *      *             ",
    "             ,      ,     *    ,,    *     ,      ,             ",
    "             ,*    *,*    ,   *,,*   ,    *,*    *,             ",
    "             ,,    ,,,    ,*  ,,,,  *,    ,,,    ,,             ",
    "      *   ,  ,,*  *,,,*  *,, *,,,,* ,,*  *,,,*  *,,  ,   *      ",
    "      ,   ,* ,,,* ,,,,,  ,,,*,,++,,*,,,  ,,,,, *,,, *,   ,      ",
    "      ,*  *,*,,,,*,,+,,,*,,,,,,++,,,,,,*,,,+,,*,,,,*,*  *,      ",
    "      ,,   ,,,,,,,,,++,,,,,,,,+**+,,,,,,,,++,,,,,,,,,   ,,      ",
    "      *,,  ,,,,,,,,,+*+,,,+,,,+**+,,,+,,,+*+,,,,,,,,,  ,,*      ",
    "      *,,, *,,,,,,,,+**+,,++,+*  *+,++,,+**+,,,,,,,,* ,,,*      ",
    "       ,,,, ,,,,+,,,+* *+,+*+**  **+*+,+* *+,,,+,,,, ,,,,       ",
    "       ,,,,,,,,,++,,+*  *+* **    ** *+*  *+,,++,,,,,,,,,       ",
    " *     *,,,,,,,,+*+,##   **  *    * ##*   *+,+*+,,,,,,,,*     * ",
    " ,*     ,,,+,,,,+**+#!#   *         #!#   *++**+,,,,+,,,     *, ",
    " ,,     ,,,,+,,,,***+#!#            #!#   *+***,,,,+,,,,     ,, ",
    " ,,,  * *,,,,+,,,+* *##!##          ##!#  ** *+,,,+,,,,* *  ,,, ",
    " *,,,* , ,,,,++,,+*  *##!!##        ##!#  *  *+,,++,,,, , *,,,* ",
    "  ,,,,, ,,,,,,+*##*   ###!!!###     ##!#     *,+*+,,,,,, ,,,,,  ",
    "  ,,,,,,*,,,,,+*#'#*   ##!!!!!!######!#!#   *+***+,,,,,*,,,,,,  ",
    "  *,,,,,,,,+,,,+*#'##  ###!#!!!!!!!!!##!#   ** *+,,,+,,,,,,,,*  ",
    "   ,,,,,,,,,++,,**#''## ###!!!!!##!!!!!!#  *  **,,++,,,,,,,,,   ",
    "   ,,,,+,,,,+*+++*#''''####!!##!#!!###!!#     *+++*+,,,,+,,,,   ",
    "   *,,,,+,,,,+****##''## ###!##!!!##$$#!#    *****+,,,,+,,,,*   ",
    "    ,,,,++,,,+*  **###!!###!!!!!!!###$#!#    **  *+,,,++,,,,    ",
    "    *,,,,++,,,+*   *##!###!!!!!##!###$#!!#  *   *+,,,++,,,,*    ",
    "     ,,,,++++,+*     #!!###!!!!##!!####!!#      *+,++++,,,,     ",
    "     *,,,,++*+,+*     #!!#####!!!!!!###!#      *+,+*++,,,,*     ",
    "  ,   ,,,,,+**+,*     #!!!#######!!!!#!#       *,+**+,,,,,   ,  ",
    "   ,  *,,,,++***+*    #!!####&##)##!!#!#      *+***++,,,,*  ,   ",
    "   ,,  ,,,,,+*  **   #!#!##&&#&&#)#####       **  *+,,,,,  ,,   ",
    "    ,, *,,,,,+*   * #!!!##!##&&#&###((#      *   *+,,,,,* ,,    ",
    "    *,, ,,+,,+*     #!!#!!#!!#&&#&&#%%##         *+,,+,, ,,*    ",
    "     ,,,,,,+,,+*   #!!#!!!#!!!###&#(((##        *+,,+,,,,,,     ",
    "      ,,,,,++,,+*  #!######!#!!!##%%%#!#       *+,,++,,,,,      ",
    "      *,,,,,++++*  ###&&&###!!!#!######  ####  *++++,,,,,*      ",
    "       ,,,,,++*++* #!#&&#####!!!!#!!#&###&#&&#*++*++,,,,,       ",
    ",       ,,,,,++**+#!#######!##########!!#&#&&#+**++,,,,,       ,",
    " ,* ,   *,,,,,++*#!##!#&&#&##(#####(##!!###&&#**++,,,,,*   , *, ",
    "  ,, ,*  ,,,+,,+*#!##!#&&#&#((###########&#&&# *+,,+,,,  *, ,,  ",
    "  *,,,,*,*,,,++,#!###!#&&&############# ##### *+,++,,,*,*,,,,*  ",
    "   ,,,,,,,,,,,++#!#####&&&###!!!!#!####       *+++,,,,,,,,,,,   ",
    "    ,,,,,,,,,,,+#!############!!!#!#&###     ***+,,,,,,,,,,,    ",
    "     ,,,+,,,,,,,#!####!!!!##&&#!##!##&&&#   * *+,,,,,,,+,,,     ",
    "     *,,,++,,,,,####  #!!###&&&#((####&#!#   *+,,,,,,++,,,*     ",
    "      *,,,++++,,,,+*   ####&&#&#%%###&##!#  *+,,,,++++,,,*      ",
    "       ,,,,+*++++,,+*    ###&#&#######&#!# *+,,++++*+,,,,       ",
    "        ,,,,+***+++++*  ##!!#&#    ###### *+++++***+,,,,        ",
    "         ,,,,+********* ##!!##     ###!!#*********+,,,,         ",
    "         *,,,,++***     ####!#     ###!!#    ***++,,,,*         ",
    "      *   *,,+,,+* *    ##!!!#     ######## * *+,,+,,*   *      ",
    "       , * +,,+,,+*     ###!!#     ###&##&&# *+,,+,,+ * ,       ",
    "        , , ++,+,,**    #####     #&###&&##&#*,,+,++ , ,        ",
    "         * , ,+,+*+**#####&&##    #&####&# ##+*+,+, , *         ",
    "            , ,+,+* #&###&##&&#    #   ###*  *+,+, ,            ",
    "             * ,*, *#&###&#####             * ,*, *             ",
    "                 *, ##  ###                * ,*                 "
  ],
  "width": 64
}
