{
  "height": 21,
  "legend": {
    "!": "12bc00",
    "#": "333333",
    "$": "666666",
    "%": "99ccff",
    "&": "b5bb47",
    "'": "cab989",
    "(": "cc9900",
    ")": "f2f2f2",
    "*": "ffc600",
    "+": "ffe242",
    ",": "fffabc"
  },
  "name": "dragon-ball-imperfect-cell-stage-2-special-beam-cannon",
  "pixels": [
    "             ###      ###                                                                                                     ",
    "            #!!!#    ###!#                                                                                                    ",
    "           #!##!!#   ####!#                                                                                                   ",
    "           #!##!!#   ####!#                                                                                                   ",
    "           #!!!!!#  #####!#                                                                                                   ",
    "          #!!!!#!#  #####!#                                                                                                   ",
    "          #!!!!!!!# ######!#                                                                                                  ",
    "          ###!!!!!########!#                                                                                                  ",
    "          ###!!!#!########!#                                                                                                  ",
    "          #!!!!!#!#$$#####!#                                                                                                  ",
    "          #!!##!!!###$####!#                                                                                                  ",
    "##        #!!#!!!!####$###!#                                                                                                  ",
    "#'###     #!!!!!!!#$$#$$##!#                   *****                                                              ******      ",
    " #'''#    #!!!!!!!#$$#$$##!#                ***+++++***               **              ***             ***       **++++++***   ",
    " #''''#   #!#!!##!!###$$#!!#               *+,,,,+,+++***            *))*            *))+*           *))+*     *+++,+,,,,,+*  ",
    " #''###  #!!!!!##!!######!!#              *,)))),,+,,++**************))++************)),+************)),+******++,,+,,))))),* ",
    " #'#(((# #!!##!!!!!!####!!!############  +,)))))),),,,,,,,,,,,,,,,,*)),*,,,,,,,,,,,*)),*,,,,,,,,,,,*)),*,,,,,,,,,,,),))))))),*",
    "  #((##(##!######!#!!##!!######!!!&&&&&# ,))))))))))))))))))))))))*,),*)))))))))))*,),*)))))))))))*,),*))))))))))))))))))))))*",
    "  #(#((#!!###(####!!!!#!#&&####!!######  ,))))))))))))))))))))))))*))*))))))))))))*))*))))))))))))*))*)))))))))))))))))))))))*",
    "   #(((#!!#!###&#)##!!#!#######!&##&#    +,)))))),),,,,,,,,,,,,,,*,),*,,,,,,,,,,,*,),*,,,,,,,,,,,*,),*,,,,,,,,,,,,,),))))))),*",
    "   #((#&#!#!!#(#&#)%####       ##&###     *,)))),,+,,++**********+))*************,))*************,))***********++,,+,,))))),* ",
    "   ####&&###!!#(#######          ##        *+,,,,+,+++***        *),*           *,),*          *+,),*          *+++,+,,,,,+*  ",
    "   ##&#&&####!!#(#####                      ***+++++***           **             ***            ****            **++++++***   ",
    "  #&&##&#########(((#                          *****                                                              ******      ",
    " #&&#&## #((########                                                                                                          ",
    " #!&&&&# ##(((((#(#                                                                                                           ",
    "#(#!&&&##############                                                                                                         ",
    "#((#!&# ###&#!!!#!!#&#                                                                                                        ",
    "#(####  ##&&&#!##!#&&&##                                                                                                      ",
    "##(((# ###&&&##((##&&#!!#                                                                                                     ",
    "#((((##(###&#&#((###&#!!#                                                                                                     ",
    "#(((#((##!!#&&#(#########                                                                                                     ",
    " #(#((###!!#&#########$$#                                                                                                     ",
    " ###((#####$##    ####$$#                                                                                                     ",
    "  ########$$#      ######                                                                                                     ",
    "   #######$$#      #(####                                                                                                     ",
    "    ########       #((###                                                                                                     ",
    "      ####(#       ###((##                                                                                                    ",
    "     #####(#        ##(((##                                                                                                   ",
    "     ####(#           #####                                                                                                   ",
    "     ###((#                                                                                                                   ",
    "     ######                                                                                                                   "
  ],
  "width": 126
}
