{
  "height": 22,
  "legend": {
    "!": "12bc00ff",
    "#": "333333ff",
    "$": "666666ff",
    "%": "99ccffff",
    "&": "b5bb47ff",
    "'": "cab989ff",
    "(": "cc9900ff",
    ")": "f2f2f2ff",
    "*": "ffc600ff",
    "+": "ffe242ff",
    ",": "fffabcff"
  },
  "name": "dragon-ball-imperfect-cell-stage-2-ki-blast",
  "pixels": [
    "             ###                                 ",
    "            #!!!##                               ",
    "           #!!!#!##                              ",
    "          #!!!!!!###                             ",
    "          #!##!!!!##                             ",
    "         #!!##!!!!##                             ",
    "         #!!!!!#!!###                            ",
    "         ##!!!!#!!###                            ",
    "         ##!!!!!!!###                            ",
    "         #!!!!!!#!!##                            ",
    "         #!!!#!!!!!#$#                           ",
    "        #!!#!!!!!!!#$#                           ",
    "        #!##!!!!##!###                           ",
    "        #!!!!!!!##!!##                           ",
    "        #!!!###!!!!!##                   ***+    ",
    "       #!!!#######!!!#                 ****+**   ",
    "       ##!###(#####!!!#    ###      +****+++++*  ",
    "       #!!###(#&#)##!!#   #&&&#       **+++,,)+* ",
    "       #!!#((#&&&#)%##    #&####    ***++,,,)))+*",
    "       ###((#(############!!#&&# +**+*+*,+,)))),*",
    "      ###!###(((#####!####!####  +**+*+*,+,)))),*",
    "     #!!!##!!#(((###!!###!!#####    ***++,,,)))+*",
    "   ##&#!#&&#!!#(((#########&&#        **+++,,)+* ",
    "  ##&####&###!!###        ###       +****+++++*  ",
    " ########!!&&#!#                       ****+**   ",
    "#(######!!!&###                          ***+    ",
    "##(#####!!!&###                                  ",
    "##((########((#                                  ",
    "#(#((###############                             ",
    "#((######!!!#&&##((########                      ",
    " #((###&&#!###&&&##(#((#'''#                     ",
    "  #(##&&&##((##&&#!#(#((#'''###                  ",
    "   ###&&&&#((#####!###((#''''''#                 ",
    "   ######&#(######!######'''###                  ",
    "   ###!!!########$######'''#                     ",
    "  ####!!!#   ###$$#   #####                      ",
    "  ###$###    ######                              ",
    " ####$$$#    #((###                              ",
    " #####$#     #((#(##                             ",
    "#(#####       ##(((##                            ",
    "#(##(#         ######                            ",
    "#((((#                                           ",
    "######                                           "
  ],
  "width": 49
}
