{
  "height": 23,
  "legend": {
    "!": "12bc00",
    "#": "333333",
    "$": "666666",
    "%": "76582c",
    "&": "b5bb47",
    "'": "cab989",
    "(": "cc9900",
    ")": "f2f2f2",
    "*": "ffb8d9",
    "+": "ffc600",
    ",": "ffe242",
    "-": "fffabc"
  },
  "name": "dragon-ball-imperfect-cell-stage-1-ki-blast",
  "pixels": [
    "     ##                                          ",
    "     #!##                                        ",
    " ###  #!!##                                      ",
    " #!####!!!!##                                    ",
    "  #!####!!!!!#                                   ",
    "   #!###!!#!!!#                                  ",
    "    #!###!!!!!!#                                 ",
    "     #!##!!##!!!#                                ",
    "     #!##!!##!!!!##                              ",
    "      #!##!!!!#!!###                             ",
    "      #!####!!!!!!###                            ",
    "       #!###!!!!!!#$#                            ",
    "       #!#!!!!!##!!#$#                           ",
    "        ##!!!!!##!!#$#                           ",
    "        #####!!!!!!!##                           ",
    "       #((######!!#!!#                   +++,    ",
    "       ####&######!!!#                 ++++,++   ",
    "       ##(#&##&##*#!!!#    ###      ,++++,,,,,+  ",
    "        ###&&&&&&#*#!!#   #&&&#       ++,,,--),+ ",
    "        ######&&&&####    #&####    +++,,---))),+",
    "       ####&&&&#&&#&######&&#&&# ,++,+,+-,-))))-+",
    "      ###!##&&&&#&&#(#!!!#&####  ,++,+,+-,-))))-+",
    "     #!!!##!#&&##&#%%#!!!#&###      +++,,---))),+",
    "    #&#!#&&#!#####((#######&&#        ++,,,--),+ ",
    "   #&####&####!#####      ###       ,++++,,,,,+  ",
    "  ###!!#&&&&&#!#                       ++++,++   ",
    "  ###!!#&&&&####                         +++,    ",
    " #!#####&&&&###                                  ",
    " #!############        ####                      ",
    " #!###########      ####'''#                     ",
    "#!#######!!!#!### ##!!!!#'''##                   ",
    "#!#####&&#!!#!#&&###!!!!#'''''#                  ",
    "#!####&&#&###!#&&&#!#!###''####                  ",
    "#!####&&#&#((###&&#!#######                      ",
    "## #####&&#%%######!##                           ",
    "   ##!!#&########!##                             ",
    "  ###!!##!!!!###!!#                              ",
    "  #####!###########                              ",
    "  ###!!!#########&#                              ",
    "  ###!!#     #&##&##                             ",
    "  ######     #&###&&#                            ",
    " ####&##      ## ####                            ",
    "#&&##&#&#                                        ",
    "#&###&###                                        ",
    "##  ###                                          "
  ],
  "width": 49
}
