{
  "height": 23,
  "legend": {
    "!": "12bc00",
    "#": "333333",
    "$": "666666",
    "%": "76582c",
    "&": "76e06a",
    "'": "9933cc",
    "(": "b5bb47",
    ")": "bd7cdf",
    "*": "cab989",
    "+": "cc9900",
    ",": "d2d774",
    "-": "e0aae0",
    ".": "f2f2f2",
    "/": "ffb8d9"
  },
  "name": "dragon-ball-imperfect-cell-stage-1-finger-beam",
  "pixels": [
    "         #                                                                                                                                                 ",
    "        #&#          #                                                                                                                                     ",
    "        ##&#        #&#                                                                                                                                    ",
    "        ##!&#       ##&#                                                                                                                                   ",
    "        ##!#&#      ##&#                                                                                                                                   ",
    "         ##!&&##    ##&#                                                                                                                                   ",
    "         ##!!&&&## ###&&#                                                                                                                                  ",
    "         ##!#&&&&&###&&##                                                                                                                                  ",
    "         ##!!&&&&&&&&&&&#                                                                                                                                  ",
    "         ##!!&#&##&&&##&#                                                                                                                                  ",
    "         #!!#!#&&&&&#$$##                                                                                                                                  ",
    "        ##!!#!!&&##&###$#                                                                                                                                  ",
    "        ###!!!!!!##&###$#                                                                                                                                  ",
    "        ########!!&&#####                                                                                                                                  ",
    "        #+########!!&###&#                    ''''                                                                                                         ",
    "        #+###,###/#!!&#&!#                  ''))''''                                                                                                       ",
    "        #####,#(##/#!!#!#                  )---)))'''                                                                                                      ",
    "        ###(,,(((,######                  )-..--)-)'''                                                                                                     ",
    "         ###(#(#((,##++#                 )-....--)-)'''''''''''''''''''''''''''''''''''''''''''''''''''''''''''''''''''''''''''''''''''''''''''''''''      ",
    "          #####(#(,#%%%################  -.......----------------------------------------------------------------------------------------------------''''  ",
    "         ###!!###(#+++#!!#((#!!!#((((((# -...........................................................................................................----''",
    "        #!#!!!&###%%%#!!#(((#!!!#(#####  -.......----------------------------------------------------------------------------------------------------''''  ",
    "       #!!#!!&&#!&###############(##(#   )-....--)-)'''''''''''''''''''''''''''''''''''''''''''''''''''''''''''''''''''''''''''''''''''''''''''''''''      ",
    "      ##!###&&&#!&&####!#        #(###    )-..--)-)'''                                                                                                     ",
    "   ###!##(##########!###!#        ##       )---)))'''                                                                                                      ",
    " ##((###((#!#######!#####!#                 ''))''''                                                                                                       ",
    "#((#(####(##+#####+#######!#                  ''''                                                                                                         ",
    " ####(#!###++#####++######!#                                                                                                                               ",
    " #((#(#!#!##########!######!#                                                                                                                              ",
    " #######!###!!!#!!#,#!#####!#                                                                                                                              ",
    " ##((##!###(#!!#!#(,##!####!#                                                                                                                              ",
    "#!####!####(,#####(,# #!####!#                                                                                                                             ",
    "#!###!# ##(((,#+##((,# #!###!#                                                                                                                             ",
    "#!##!#  ##(((,#####(,####!!#!#                                                                                                                             ",
    "#!#!#   ####(,########!!!##!!#                                                                                                                             ",
    "#!!#    ##!&#,#####!&####!!###                                                                                                                             ",
    "###     ##!&##!!###!&######!##                                                                                                                             ",
    "        ####&#!!#############*#                                                                                                                            ",
    "        ##!&&######!&&# #####*#                                                                                                                            ",
    "        ##!&&#######&&#  ###**#                                                                                                                            ",
    "        ##### #####!###  #****#                                                                                                                            ",
    "       ####,#    ####,#   #****#                                                                                                                           ",
    "       ###(,##   #(#,,##   ###*#                                                                                                                           ",
    "     ##(##(#,#   #(#(#(,#     ##                                                                                                                           ",
    "     #(##(,###   ## #(#(,#                                                                                                                                 ",
    "     ## ###          #####                                                                                                                                 "
  ],
  "width": 155
}
