{
  "height": 22,
  "legend": {
    "!": "12bc00",
    "#": "333333",
    "$": "666666",
    "%": "76582c",
    "&": "b5bb47",
    "'": "cab989",
    "(": "cc9900",
    ")": "ffb8d9"
  },
  "name": "dragon-ball-imperfect-cell-stage-1",
  "pixels": [
    "    ##              ##        ",
    "    #!#             #!#       ",
    "     #!#            #!#       ",
    "     ##!##          ##!#      ",
    "      ##!!##        ##!#      ",
    "##    ###!!!###     ##!#      ",
    "#'#    ##!!!!!!######!#!#     ",
    " #'##  ###!#!!!!!!!!!##!#     ",
    "  #''## ###!!!!!##!!!!!!#     ",
    "  #''''####!!##!#!!###!!#     ",
    "  ##''## ###!##!!!##$$#!#     ",
    "   ###!!###!!!!!!!###$#!#     ",
    "    ##!###!!!!!##!###$#!!#    ",
    "     #!!###!!!!##!!####!!#    ",
    "      #!!#####!!!!!!###!#     ",
    "      #!!!#######!!!!#!#      ",
    "      #!!####&##)##!!#!#      ",
    "     #!#!##&&#&&#)#####       ",
    "    #!!!##!##&&#&###((#       ",
    "    #!!#!!#!!#&&#&&#%%##      ",
    "   #!!#!!!#!!!###&#(((##      ",
    "   #!######!#!!!##%%%#!#      ",
    "   ###&&&###!!!#!######  #### ",
    "   #!#&&#####!!!!#!!#&###&#&&#",
    "  #!#######!##########!!#&#&&#",
    " #!##!#&&#&##(#####(##!!###&&#",
    " #!##!#&&#&#((###########&#&&#",
    "#!###!#&&&############# ##### ",
    "#!#####&&&###!!!!#!####       ",
    "#!############!!!#!#&###      ",
    "#!####!!!!##&&#!##!##&&&#     ",
    "####  #!!###&&&#((####&#!#    ",
    "       ####&&#&#%%###&##!#    ",
    "         ###&#&#######&#!#    ",
    "        ##!!#&#    ######     ",
    "        ##!!##     ###!!#     ",
    "        ####!#     ###!!#     ",
    "        ##!!!#     ########   ",
    "        ###!!#     ###&##&&#  ",
    "        #####     #&###&&##&# ",
    "     #####&&##    #&####&# ## ",
    "    #&###&##&&#    #   ###    ",
    "    #&###&#####               ",
    "    ##  ###                   "
  ],
  "width": 30
}
